########################################
#S                                     #
#                                      #
#                                      #
#                                      #
#                                      #
#                                      #
#                                      #
#                                      #
####                                   #
#                #                     #
#                #                     #
#                                      #
#       #@                             #
#       ##########                     #
#                                      #
#                                      #
#                                      #
#                                      #
#                                      #
########################################
