########################################
#S     #        ##########             #
#      #        #####    #       #     #
#      #  #     ##  #           #    @ #
###### #  # #####             #        #
#    #    # ###     #        #      #  #
#    ###### ### ##    #                #
# #         ### #######                #
#     ########  #   #     # #          #
#     #     #   #  #         #         #
#  #  #         #       #              #
#### ##   #######      #       #       #
#          #         #                 #
#######    #        ##               # #
#     #    #   #                #     ##
#     #    #             #         # # #
#  #  ######                           #
#               #      #   #           #
# #          #          ##   # #       #
#  #        #             ### #        #
########################################
